{
  "spritesheets": ["wolfenstein"],
  "map": {
    "type": "static",
    "cells": [
      [ 7, 7, 7, 7, 7, 7, 7, 7, 7, 7, 7, 3, 3, 5, 3, 3, 5, 3, 5, 3, 3, 3, 5, 3 ],
      [ 7, -1, -1, -1, -1, -1, -1, -1, -1, -1, 7, 3, -1, -1, -1, -1, -1, -1, -1, -1, -1, -1, -1, 3 ],
      [ 7, -1, 2, 2, -1, -1, -1, -1, -1, 7, 7, 3, -1, -1, -1, -1, -1, -1, -1, -1, -1, -1, -1, 5 ],
      [ 7, -1, -1, 2, -1, -1, -1, -1, -1, -1, -1, 100, -1, -1, -1, -1, -1, 99, -1, -1, -1, -1, -1, 5 ],
      [ 7, -1, 2, 2, -1, -1, -1, -1, -1, 7, 7, 3, -1, -1, -1, -1, -1, -1, -1, -1, -1, -1, -1, 3 ],
      [ 7, -1, -1, -1, -1, -1, -1, -1, -1, -1, 7, 3, -1, -1, -1, -1, -1, 5, 5, 5, -1, 5, 3, 5 ],
      [ 7, 7, 7, 7, -1, 7, 7, 7, 7, 7, 7, 3, 3, 3, 3, 3, 3, 5, -1, -1, -1, -1, -1, 5 ],
      [ 6, 6, 6, 6, -1, 6, 6, 6, 6, -1, 7, -1, 7, -1, 7, -1, 7, 3, -1, 3, -1, 5, -1, 5 ],
      [ 6, 6, -1, -1, -1, -1, -1, -1, 6, 7, -1, 7, -1, 7, -1, 7, 7, 5, -1, -1, -1, -1, -1, 5 ],
      [ 6, -1, -1, -1, -1, -1, -1, -1, -1, -1, -1, -1, -1, -1, -1, -1, 7, 5, -1, -1, -1, -1, -1, 3 ],
      [ 6, -1, -1, -1, -1, -1, -1, -1, -1, -1, -1, -1, -1, -1, -1, -1, 7, 5, -1, 5, -1, 5, -1, 5 ],
      [ 6, 6, -1, -1, -1, -1, -1, -1, 6, 7, -1, 7, -1, 7, -1, 7, 7, 5, 3, 5, -1, 5, 5, 5 ],
      [ 6, 6, 6, 6, -1, 6, 6, 6, 6, 7, 7, 3, -1, 5, 7, 3, 7, 2, 2, 2, -1, 2, 2, 2 ],
      [ 1, 1, 1, 1, -1, 1, 1, 1, 1, 3, 5, 3, -1, -1, 5, -1, 5, 2, -1, -1, -1, -1, -1, 2 ],
      [ 1, 1, -1, -1, -1, -1, -1, 1, 1, 3, -1, -1, -1, -1, -1, -1, 3, 2, -1, -1, -1, -1, -1, 2 ],
      [ 1, -1, -1, -1, -1, -1, -1, -1, 1, 3, -1, -1, -1, -1, -1, -1, 3, 2, -1, -1, -1, -1, -1, 2 ],
      [ 0, -1, -1, -1, -1, -1, -1, -1, 0, 3, 3, 3, 3, 3, 5, -1, 5, 2, 2, -1, -1, -1, 2, 2 ],
      [ 1, -1, -1, -1, -1, -1, -1, -1, 1, 1, 1, 0, 1, 1, 1, 5, 5, -1, -1, 4, -1, 4, -1, 4 ],
      [ 1, 1, -1, -1, -1, -1, -1, 1, 1, 1, -1, -1, -1, 1, 1, -1, 4, -1, 4, -1, -1, -1, 4, 4 ],
      [ 1, -1, -1, -1, -1, -1, -1, -1, 1, -1, -1, -1, -1, -1, 1, 4, -1, 4, -1, 4, -1, 4, -1, 4 ],
      [ 0, -1, -1, -1, -1, -1, -1, -1, -1, -1, -1, -1, -1, -1, -1, -1, -1, -1, -1, -1, -1, -1, -1, 4 ],
      [ 1, -1, -1, -1, -1, -1, -1, -1, 1, -1, -1, -1, -1, -1, 1, 4, -1, 4, -1, 4, -1, 4, -1, 4 ],
      [ 1, 1, -1, -1, -1, -1, -1, 1, 1, 1, -1, -1, -1, 1, 1, -1, 4, -1, 4, -1, -1, -1, 4, 4 ],
      [ 1, 1, 1, 1, 0, 1, 1, 1, 1, 1, 1, 0, 1, 1, 1, 4, 4, 4, 4, 4, 4, 4, 4, 4 ]
    ]
  },
  "entities": [
    {
      "tileX": 9,
      "tileY": 3,
      "template": "misc_items:barrel"
    },
    {
      "tileX": 13,
      "tileY": 3,
      "template": "misc_items:barrel"
    },
    {
      "tileX": 14,
      "tileY": 4,
      "template": "misc_items:barrel"
    }
  ]
}
